. . F . F . F . .
. . . . . . . . .
. . ! . . . . . .
. . . . . . . . .
. . . ! ! ! . . .
. . . . . . . . .
. . . . . . . . .
. . . . S . . . .
. . . . ! . . . .