. . . . F . . . .
. . . . . . . . .
. . . . . . . . .
. . . . . . . . .
F . . ! ! ! . . F
. . . . . . . . .
. . . . . . . . .
. . . . S . . . .
. . . . ! . . . .